#######################################
#######################################
######### ####### ######## ####### ####
######    ######            #####   ###
###### ## ###### #######   ####  #  ###
#####  ##  ####  ######   ######  #####
##### # ##  ########### ###############
#####   ###             ###############
######  ### ####### ###################
#######    ########B###################
####### # #########     ###############
#######  ############## ######## ######
#######  ############## ######## ######
#####  #   #            ######## ######
##### ###    #  #  #### ######## ######
##### ## ###### ##      ######## ######
##### ## ###### ###### ######### ######
#####    ###### ###### ################
############### #####           A######
#######################################
