#######################################
#######################################
######### ####### ######## ####### ####
######    ######            #####   ###
###### ## ###### #######   ####  #  ###
#####  ##  ####  ######   ######  #####
##### # ##  ########### ###############
#####   ###             ###############
######  ### ####### ###################
#######    ########B###################
####### # #############################
#######  ####################### ######
#######  ####################### ######
#####  #   #      ############## ######
##### ###    #  #  ############# ######
##### ## ###### ##     ######### ######
##### ## ###### ###### ######### ######
#####    ###### ###### ################
############### #####           A######
#######################################
