################
#A             #
# ############ #
# ############ #
#             B#
################
